3,5,3,5,3,5,3,5,3,3
3,0,3,0,3,0,3,0,3,1
3,0,4,0,4,0,4,0,4,0
3,0,4,0,4,0,4,0,4,0
3,0,4,0,4,0,4,0,4,0
3,0,4,0,4,0,4,0,4,0
3,0,4,0,4,0,4,0,4,0
3,0,4,0,4,0,4,0,4,0
3,0,4,0,4,0,4,0,4,0
3,0,4,0,4,0,4,0,4,0
