3,3,3,3,3,3,3,3,3,3
3,0,4,4,4,4,4,4,4,3
3,4,4,4,4,4,4,4,4,3
3,4,4,4,4,4,4,4,4,3
3,4,4,4,4,4,4,4,4,3
3,4,4,4,4,4,4,4,4,3
3,4,4,4,4,4,4,4,4,3
3,4,4,4,4,4,4,4,4,3
3,4,4,4,4,4,4,4,4,3
3,3,3,3,3,3,3,3,3,3
