3,5,5,5,5,5,5,5,5,3
3,0,0,0,0,0,0,0,0,3
3,4,4,4,4,4,4,4,4,3
3,4,4,4,4,4,4,4,4,3
3,4,4,4,4,4,4,4,4,3
3,4,4,4,4,4,4,4,4,3
3,4,4,4,4,4,4,4,4,3
3,4,4,4,4,4,4,4,4,3
3,4,4,4,4,4,4,4,4,3
3,3,3,3,3,3,3,3,3,3
