3,3,3,3,3,3,3,3,3,3
3,0,4,1,3,3,3,3,3,3
3,0,3,3,3,3,3,3,3,3
3,0,4,0,0,0,1,3,3,3
3,0,3,3,3,3,3,3,3,3
3,0,4,0,0,1,3,3,3,3
3,0,3,3,3,3,3,3,3,3
3,0,4,0,0,0,0,0,1,3
3,0,3,3,3,3,3,3,3,3
3,0,4,0,0,0,0,1,3,3
